1000000000000000000000
1110000000000000000000
0011000000000000000000
0001000000000000330000
0000100000000000033000
0000011000000000003300
0000001100000000003300
0000000220000003330000
0000000020000003000000
0000000002222223000000
0000000000000000000000
0000000000000000000000
0000000000000000000000
0000000000000000000000
0000000000000000000000
0000000000000000000000
0000000000000000000000
