21000122222101222222222444444444444444444444444444444
21030122222101111111222444444444444444444444444444444
21000122222100000001222444444444444444444444444444444
21101122222222222201222222222222224444444444444444444
22202222222222222201222111111111124444444444444444444
22101111112100000000000000000000124444444444444444444
22100000012101111111222111111110124444444444444444444
22222222012102222222222222222210124444444444444444444
22100000012100000122222444444210124444444444444444444
22101222222111110122222444444210111111111100000000000
22101222222222210122222444444210000000000000000000000
22101222100001210122222444444210111111111100000000000
22101222102201210122222444444210124444444444444444444
22100000002201210122222444444210124444444444444444444
22111111112201110122222444444210124444444444444444444
22222222222200000122222444444210124444444444444444444
22222222222222222222222444444210124444444444444444444
44444444444444444444444444444222224444444444444444444
44444444444444444444444444444444444444444444444444444
44444444444444444444444444444444444444444444444444444
44444444444444444444444444444444444400444444444444444
44444444444444444444444444444444444400444444444444444
44444444444444444444444444444444444444444444444444444
44444444444444444444444444444444444444444444444444444
44444444444444444444444444444444444444444444444444444
44444444444444444444444444444444444444444444444444444
44444444444444444444444444444444444444444444444444444